gif	image/gif
png	image/png
jpg	image/jpeg
jpeg	image/jpeg
3gp	video/3gpp
mpg	video/mpeg
mpeg	video/mpeg
mpe	video/mpeg
mp4	video/mp4
qt	video/quicktime
mov	video/quicktime
flv	video/x-flv
avi	video/avi
wmv	video/x-ms-wmv
mp3	audio/mpeg
m4a	audio/mpeg
wav	audio/wav
wma	audio/x-ms-wma
aac	audio/aac
oga	audio/ogg
